{
	"name": "First map",
	
	"world": {
		"size": [20, 20],
		"tileset": "aztec",
		"background": "back.png",
		"tiles": [
			1,  1,  1,  1,  1,  1,  1,  1,  1,  1,  1,  1,  1,  1,  1,  1,  1,  1,  1,  1,
			1, 37,  1, 37, 37, 37, 37, 37, 37, 37, 37, 37,  1, 37, 37, 37, 37, 37, 37,  1,
			1, 37, 37, 37, 37, 37, 37, 37, 37, 37, 37, 37, 37, 37, 37, 37, 37, 37, 37,  1,
			1, 37, 37, 37, 37, 37, 37, 37, 37,  1, 37, 37, 37, 37, 37, 37, 37, 37, 37,  1,
			1, 37, 37, 37, 37, 37, 37, 37, 37, 37, 37, 37, 37, 37, 37, 37, 37, 37, 37,  1,
			1,  1, 37,  5, 37, 37, 37, 37, 37, 37, 37, 37, 37, 37, 37,  1, 37, 37, 37,  1,
			1, 37, 37, 37, 37, 37, 37, 37, 37, 37, 37, 37, 37, 37, 37, 37, 37, 37, 37,  1,
			1, 37, 37, 37, 37, 37, 37, 37, 37, 37, 37, 37, 37, 37, 37, 37, 37, 37, 37,  1,
			1, 37, 37, 37, 37, 37, 37, 37, 37, 37, 37, 37, 37, 37, 37, 37, 37, 37, 37,  1,
			1, 37, 37, 37, 37, 36, 36, 36, 37,  1, 37, 37, 37, 37, 37, 37, 37, 37, 37,  1,
			1,  1, 37, 37, 37, 37, 37, 37, 37, 37, 37,  1, 37, 37, 37, 37, 37, 37, 37,  1, 
			1, 37,  1, 37, 37, 37, 37, 37, 37, 37, 37, 37,  1, 37, 37, 37, 37, 37, 37,  1,
			1, 37, 37, 37, 37, 34, 34, 34, 34, 34, 34, 37, 37, 37, 37, 37, 37, 37, 37,  1,
			1, 37, 37, 37, 37, 34, 34, 34, 34, 34, 34, 37, 37, 37, 37, 37, 37, 37, 37,  1,
			1, 45, 45, 45, 45, 34, 34, 34, 34, 34, 34, 37, 37, 37, 37, 37,  0, 37, 37,  1,
			1, 45, 45, 45, 45, 34, 34, 34, 34, 34, 34, 37, 37, 37, 37,  0,  0, 37, 37,  1,
			1, 45, 45, 45, 45, 34, 34, 34, 34, 34, 34, 37, 37, 37, 37, 37, 37, 37, 37,  1,
			1, 45, 45, 45, 45, 34, 34, 34, 34, 34, 34, 37, 37, 37, 37, 37, 37, 37, 37,  1,
			1, 45, 45, 45, 45, 34, 34, 34, 34, 34, 34, 37, 37, 37, 37, 37, 37, 37, 37,  1,
			1,  1,  1,  1,  1,  1,  1,  1,  1,  1,  1,  1,  1,  1,  1,  1,  1,  1,  1,  1
		]
	},

	"entities": [
		{
			"class": "player",
			"name": "player0",
			"pos": [320, 320]
		},
		{
			"class": "item_gem",
			"name": "thegem",
			"pos": [96, 96]
		},
		{
			"class": "item_gem",
			"pos": [544, 96]
		},
		{
			"class": "item_gem",
			"pos": [544, 544]
		},
		{
			"class": "item_gem",
			"pos": [96, 544]
		}
	]
}