{
	"name": "First map",
	
	"world": {
		"size": [20, 20],
		"tileset": "aztec",
		"background": "back.png",
		"tiles": [
			37, 1, 37, 37, 37, 37, 37, 37, 37, 37, 37, 1, 37, 37, 37, 37, 37, 37, 37, 37, 
			37, 37, 1, 37, 37, 37, 37, 37, 37, 37, 37, 37, 1, 37, 37, 37, 37, 37, 37, 37,
			37, 37, 37, 37, 37, 37, 37, 37, 37, 37, 37, 37, 37, 37, 37, 37, 37, 37, 37, 37,
			37, 37, 37, 37, 37, 37, 37, 37, 37, 1, 37, 37, 37, 37, 37, 37, 37, 37, 37, 37,
			37, 37, 37, 37, 37, 37, 37, 37, 37, 37, 37, 37, 37, 37, 37, 37, 37, 37, 37, 37,
			37, 1, 37, 5, 37, 37, 37, 37, 37, 37, 37, 37, 37, 37, 37, 1, 37, 37, 37, 37,
			37, 37, 37, 37, 37, 37, 37, 37, 37, 37, 37, 37, 37, 37, 37, 37, 37, 37, 37, 37,
			37, 37, 37, 37, 37, 37, 37, 37, 37, 37, 37, 37, 37, 37, 37, 37, 37, 37, 37, 37,
			37, 37, 37, 37, 37, 37, 37, 37, 37, 37, 37, 37, 37, 37, 37, 37, 37, 37, 37, 37,
			37, 37, 37, 37, 37, 36, 36, 36, 37, 1, 37, 37, 37, 37, 37, 37, 37, 37, 37, 1,
			37, 1, 37, 37, 37, 37, 37, 37, 37, 37, 37, 1, 37, 37, 37, 37, 37, 37, 37, 37, 
			37, 37, 1, 37, 37, 37, 37, 37, 37, 37, 37, 37, 1, 37, 37, 37, 37, 37, 37, 37,
			37, 37, 37, 37, 37, 34, 37, 34, 37, 37, 34, 37, 37, 37, 37, 37, 37, 37, 37, 37,
			37, 37, 37, 37, 37, 34, 37, 34, 37, 37, 34, 37, 37, 37, 37, 37, 37, 37, 37, 37,
			37, 37, 37, 37, 37, 34, 37, 34, 37, 37, 34, 37, 37, 37, 37, 37, 37, 37, 37, 37,
			37, 37, 37, 37, 37, 34, 37, 34, 37, 37, 34, 37, 37, 37, 37, 37, 37, 37, 37, 37,
			37, 37, 37, 37, 37, 34, 37, 34, 37, 37, 34, 37, 37, 37, 37, 37, 37, 37, 37, 37,
			37, 37, 37, 37, 37, 34, 37, 34, 37, 37, 34, 37, 37, 37, 37, 37, 37, 37, 37, 37,
			37, 37, 37, 37, 37, 34, 37, 34, 37, 37, 34, 37, 37, 37, 37, 37, 37, 37, 37, 37,
			37, 37, 37, 37, 37, 34, 37, 34, 37, 1,  34, 37, 37, 37, 37, 37, 37, 37, 37, 1
		]
	},

	"entities": [
		{
			"class": "player",
			"name": "player0",
			"pos": [200, 200]
		},
		{
			"class": "item_gem",
			"name": "thegem",
			"pos": [20, 20]
		},
		{
			"class": "item_gem",
			"pos": [30, 30]
		},
		{
			"class": "item_gem",
			"pos": [40, 30]
		},
		{
			"class": "item_gem",
			"pos": [60, 80]
		}
	]
}